tool,T,tp,fp,tn,fn,fp+fn,precision,recall,f1
7zncd-BZip2-1,39,386,44,1956,114,158,0.897674419,0.772,0.830107527
7zncd-BZip2-3,39,386,44,1956,114,158,0.897674419,0.772,0.830107527
7zncd-BZip2-5,39,386,44,1956,114,158,0.897674419,0.772,0.830107527
7zncd-BZip2-7,37,394,80,1920,106,186,0.831223629,0.788,0.809034908
7zncd-BZip2-9,37,394,80,1920,106,186,0.831223629,0.788,0.809034908
7zncd-default,32,415,116,1884,85,201,0.781544256,0.83,0.805043647
7zncd-Deflate-1,32,331,20,1980,169,189,0.943019943,0.662,0.777908343
7zncd-Deflate-3,32,331,20,1980,169,189,0.943019943,0.662,0.777908343
7zncd-Deflate-5,29,413,132,1868,87,219,0.757798165,0.826,0.790430622
7zncd-Deflate-7,30,413,104,1896,87,191,0.798839458,0.826,0.812192724
7zncd-Deflate-9,30,416,104,1896,84,188,0.8,0.832,0.815686275
7zncd-Deflate64-1,32,331,19,1981,169,188,0.945714286,0.662,0.778823529
7zncd-Deflate64-3,32,331,19,1981,169,188,0.945714286,0.662,0.778823529
7zncd-Deflate64-5,29,413,132,1868,87,219,0.757798165,0.826,0.790430622
7zncd-Deflate64-7,30,413,104,1896,87,191,0.798839458,0.826,0.812192724
7zncd-Deflate64-9,30,414,103,1897,86,189,0.800773694,0.828,0.814159292
7zncd-LZMA-1,35,336,16,1984,164,180,0.954545455,0.672,0.788732394
7zncd-LZMA-3,35,337,17,1983,163,180,0.951977401,0.674,0.789227166
7zncd-LZMA-5,32,415,116,1884,85,201,0.781544256,0.83,0.805043647
7zncd-LZMA-7,33,417,105,1895,83,188,0.798850575,0.834,0.816046967
7zncd-LZMA-9,33,417,105,1895,83,188,0.798850575,0.834,0.816046967
7zncd-LZMA2-1,36,330,9,1991,170,179,0.973451327,0.66,0.786650775
7zncd-LZMA2-3,36,330,9,1991,170,179,0.973451327,0.66,0.786650775
7zncd-LZMA2-5,32,418,119,1881,82,201,0.77839851,0.836,0.806171649
7zncd-LZMA2-7,34,398,74,1926,102,176,0.843220339,0.796,0.818930041
7zncd-LZMA2-9,34,398,74,1926,102,176,0.843220339,0.796,0.818930041
7zncd-PPMd-1,32,377,84,1916,123,207,0.817787419,0.754,0.784599376
7zncd-PPMd-3,32,377,84,1916,123,207,0.817787419,0.754,0.784599376
7zncd-PPMd-5,33,390,93,1907,110,203,0.807453416,0.78,0.793489318
7zncd-PPMd-7,34,417,116,1884,83,199,0.782363977,0.834,0.807357212
7zncd-PPMd-9,35,412,108,1892,88,196,0.792307692,0.824,0.807843137
bsdiff,71,231,66,1934,269,335,0.777777778,0.462,0.579673777
bzip2ncd-1,30,420,102,1898,80,182,0.804597701,0.84,0.821917808
bzip2ncd-2,30,420,102,1898,80,182,0.804597701,0.84,0.821917808
bzip2ncd-3,30,420,102,1898,80,182,0.804597701,0.84,0.821917808
bzip2ncd-4,30,420,102,1898,80,182,0.804597701,0.84,0.821917808
bzip2ncd-5,30,420,102,1898,80,182,0.804597701,0.84,0.821917808
bzip2ncd-6,30,420,102,1898,80,182,0.804597701,0.84,0.821917808
bzip2ncd-7,30,420,102,1898,80,182,0.804597701,0.84,0.821917808
bzip2ncd-8,30,420,102,1898,80,182,0.804597701,0.84,0.821917808
bzip2ncd-9,30,420,102,1898,80,182,0.804597701,0.84,0.821917808
bzip2ncd-default,30,420,102,1898,80,182,0.804597701,0.84,0.821917808
ccfx-10-10,9,348,100,1900,152,252,0.776785714,0.696,0.734177215
ccfx-10-11,11,300,42,1958,200,242,0.877192982,0.6,0.712589074
ccfx-10-12,0,352,196,1804,148,344,0.642335766,0.704,0.671755725
ccfx-10-1,31,318,8,1992,182,190,0.975460123,0.636,0.769975787
ccfx-10-2,31,318,8,1992,182,190,0.975460123,0.636,0.769975787
ccfx-10-3,31,318,8,1992,182,190,0.975460123,0.636,0.769975787
ccfx-10-4,31,318,8,1992,182,190,0.975460123,0.636,0.769975787
ccfx-10-5,31,318,8,1992,182,190,0.975460123,0.636,0.769975787
ccfx-10-6,31,316,0,2000,184,184,1,0.632,0.774509804
ccfx-10-7,27,330,16,1984,170,186,0.953757225,0.66,0.780141844
ccfx-10-8,12,376,82,1918,124,206,0.820960699,0.752,0.784968685
ccfx-10-9,14,348,50,1950,152,202,0.874371859,0.696,0.775055679
ccfx-15-10,0,420,200,1800,80,280,0.677419355,0.84,0.75
ccfx-15-11,0,420,184,1816,80,264,0.695364238,0.84,0.760869565
ccfx-15-12,2,316,100,1900,184,284,0.759615385,0.632,0.689956332
ccfx-15-1,9,396,96,1904,104,200,0.804878049,0.792,0.798387097
ccfx-15-2,9,396,96,1904,104,200,0.804878049,0.792,0.798387097
ccfx-15-3,9,396,96,1904,104,200,0.804878049,0.792,0.798387097
ccfx-15-4,9,396,96,1904,104,200,0.804878049,0.792,0.798387097
ccfx-15-5,9,396,96,1904,104,200,0.804878049,0.792,0.798387097
ccfx-15-6,11,366,52,1948,134,186,0.875598086,0.732,0.797385621
ccfx-15-7,11,366,52,1948,134,186,0.875598086,0.732,0.797385621
ccfx-15-8,10,360,42,1958,140,182,0.895522388,0.72,0.798226164
ccfx-15-9,8,360,58,1942,140,198,0.861244019,0.72,0.784313725
ccfx-16-1,9,396,76,1924,104,180,0.838983051,0.792,0.814814815
ccfx-16-2,9,396,76,1924,104,180,0.838983051,0.792,0.814814815
ccfx-16-3,9,396,76,1924,104,180,0.838983051,0.792,0.814814815
ccfx-16-4,9,396,76,1924,104,180,0.838983051,0.792,0.814814815
ccfx-16-5,9,396,76,1924,104,180,0.838983051,0.792,0.814814815
ccfx-16-6,12,340,8,1992,160,168,0.977011494,0.68,0.801886792
ccfx-16-7,12,340,8,1992,160,168,0.977011494,0.68,0.801886792
ccfx-16-8,10,360,40,1960,140,180,0.9,0.72,0.8
ccfx-16-9,8,360,56,1944,140,196,0.865384615,0.72,0.786026201
ccfx-17-1,12,340,0,2000,160,160,1,0.68,0.80952381
ccfx-17-2,12,340,0,2000,160,160,1,0.68,0.80952381
ccfx-17-3,12,340,0,2000,160,160,1,0.68,0.80952381
ccfx-17-4,12,340,0,2000,160,160,1,0.68,0.80952381
ccfx-17-5,12,340,0,2000,160,160,1,0.68,0.80952381
ccfx-17-6,12,332,0,2000,168,168,1,0.664,0.798076923
ccfx-17-7,12,332,0,2000,168,168,1,0.664,0.798076923
ccfx-17-8,12,332,0,2000,168,168,1,0.664,0.798076923
ccfx-17-9,8,360,56,1944,140,196,0.865384615,0.72,0.786026201
ccfx-18-1,5,428,34,1966,72,106,0.926406926,0.856,0.88981289
ccfx-18-2,5,428,34,1966,72,106,0.926406926,0.856,0.88981289
ccfx-18-3,5,428,34,1966,72,106,0.926406926,0.856,0.88981289
ccfx-18-4,5,428,34,1966,72,106,0.926406926,0.856,0.88981289
ccfx-18-5,5,428,34,1966,72,106,0.926406926,0.856,0.88981289
ccfx-18-6,5,428,34,1966,72,106,0.926406926,0.856,0.88981289
ccfx-18-7,5,428,34,1966,72,106,0.926406926,0.856,0.88981289
ccfx-18-8,5,392,24,1976,108,132,0.942307692,0.784,0.855895197
ccfx-18-9,2,418,72,1928,82,154,0.853061224,0.836,0.844444444
ccfx-19-1,5,428,34,1966,72,106,0.926406926,0.856,0.88981289
ccfx-19-2,5,428,34,1966,72,106,0.926406926,0.856,0.88981289
ccfx-19-3,5,428,34,1966,72,106,0.926406926,0.856,0.88981289
ccfx-19-4,5,428,34,1966,72,106,0.926406926,0.856,0.88981289
ccfx-19-5,5,428,34,1966,72,106,0.926406926,0.856,0.88981289
ccfx-19-6,5,428,34,1966,72,106,0.926406926,0.856,0.88981289
ccfx-19-7,5,428,34,1966,72,106,0.926406926,0.856,0.88981289
ccfx-19-8,5,392,24,1976,108,132,0.942307692,0.784,0.855895197
ccfx-19-9,2,418,72,1928,82,154,0.853061224,0.836,0.844444444
ccfx-20-10,0,376,24,1976,124,148,0.94,0.752,0.835555556
ccfx-20-11,0,376,24,1976,124,148,0.94,0.752,0.835555556
ccfx-20-12,0,316,0,2000,184,184,1,0.632,0.774509804
ccfx-20-1,4,452,42,1958,48,90,0.914979757,0.904,0.90945674
ccfx-20-2,4,452,42,1958,48,90,0.914979757,0.904,0.90945674
ccfx-20-3,4,452,42,1958,48,90,0.914979757,0.904,0.90945674
ccfx-20-4,4,452,42,1958,48,90,0.914979757,0.904,0.90945674
ccfx-20-5,4,452,42,1958,48,90,0.914979757,0.904,0.90945674
ccfx-20-6,4,452,42,1958,48,90,0.914979757,0.904,0.90945674
ccfx-20-7,4,452,42,1958,48,90,0.914979757,0.904,0.90945674
ccfx-20-8,3,400,32,1968,100,132,0.925925926,0.8,0.858369099
ccfx-20-9,0,418,56,1944,82,138,0.88185654,0.836,0.858316222
ccfx-21-1,3,452,42,1958,48,90,0.914979757,0.904,0.90945674
ccfx-21-2,3,452,42,1958,48,90,0.914979757,0.904,0.90945674
ccfx-21-3,3,452,42,1958,48,90,0.914979757,0.904,0.90945674
ccfx-21-4,3,452,42,1958,48,90,0.914979757,0.904,0.90945674
ccfx-21-5,3,452,42,1958,48,90,0.914979757,0.904,0.90945674
ccfx-21-6,3,452,42,1958,48,90,0.914979757,0.904,0.90945674
ccfx-21-7,3,452,42,1958,48,90,0.914979757,0.904,0.90945674
ccfx-21-8,3,400,32,1968,100,132,0.925925926,0.8,0.858369099
ccfx-21-9,0,414,56,1944,86,142,0.880851064,0.828,0.853608247
ccfx-22-1,3,452,42,1958,48,90,0.914979757,0.904,0.90945674
ccfx-22-2,3,452,42,1958,48,90,0.914979757,0.904,0.90945674
ccfx-22-3,3,452,42,1958,48,90,0.914979757,0.904,0.90945674
ccfx-22-4,3,452,42,1958,48,90,0.914979757,0.904,0.90945674
ccfx-22-5,3,452,42,1958,48,90,0.914979757,0.904,0.90945674
ccfx-22-6,3,452,42,1958,48,90,0.914979757,0.904,0.90945674
ccfx-22-7,2,452,42,1958,48,90,0.914979757,0.904,0.90945674
ccfx-22-8,2,418,34,1966,82,116,0.924778761,0.836,0.878151261
ccfx-22-9,0,414,32,1968,86,118,0.928251121,0.828,0.875264271
ccfx-23-1,0,452,50,1950,48,98,0.900398406,0.904,0.902195609
ccfx-23-2,0,452,50,1950,48,98,0.900398406,0.904,0.902195609
ccfx-23-3,0,452,50,1950,48,98,0.900398406,0.904,0.902195609
ccfx-23-4,0,452,50,1950,48,98,0.900398406,0.904,0.902195609
ccfx-23-5,0,452,50,1950,48,98,0.900398406,0.904,0.902195609
ccfx-23-6,0,452,50,1950,48,98,0.900398406,0.904,0.902195609
ccfx-23-7,2,452,42,1958,48,90,0.914979757,0.904,0.90945674
ccfx-23-8,2,410,32,1968,90,122,0.92760181,0.82,0.870488323
ccfx-23-9,0,398,32,1968,102,134,0.925581395,0.796,0.855913978
ccfx-24-1,2,452,42,1958,48,90,0.914979757,0.904,0.90945674
ccfx-24-2,2,452,42,1958,48,90,0.914979757,0.904,0.90945674
ccfx-24-3,2,452,42,1958,48,90,0.914979757,0.904,0.90945674
ccfx-24-4,2,452,42,1958,48,90,0.914979757,0.904,0.90945674
ccfx-24-5,2,452,42,1958,48,90,0.914979757,0.904,0.90945674
ccfx-24-6,2,452,42,1958,48,90,0.914979757,0.904,0.90945674
ccfx-24-7,2,452,42,1958,48,90,0.914979757,0.904,0.90945674
ccfx-24-8,2,408,32,1968,92,124,0.927272727,0.816,0.868085106
ccfx-24-9,0,396,32,1968,104,136,0.925233645,0.792,0.853448276
ccfx-25-10,0,344,0,2000,156,156,1,0.688,0.815165877
ccfx-25-11,0,344,0,2000,156,156,1,0.688,0.815165877
ccfx-25-12,0,304,0,2000,196,196,1,0.608,0.756218905
ccfx-25-1,2,420,32,1968,80,112,0.92920354,0.84,0.882352941
ccfx-25-2,2,420,32,1968,80,112,0.92920354,0.84,0.882352941
ccfx-25-3,2,420,32,1968,80,112,0.92920354,0.84,0.882352941
ccfx-25-4,2,420,32,1968,80,112,0.92920354,0.84,0.882352941
ccfx-25-5,2,420,32,1968,80,112,0.92920354,0.84,0.882352941
ccfx-25-6,2,420,32,1968,80,112,0.92920354,0.84,0.882352941
ccfx-25-7,2,420,32,1968,80,112,0.92920354,0.84,0.882352941
ccfx-25-8,2,404,24,1976,96,120,0.943925234,0.808,0.870689655
ccfx-25-9,0,392,24,1976,108,132,0.942307692,0.784,0.855895197
ccfx-30-10,0,268,0,2000,232,232,1,0.536,0.697916667
ccfx-30-11,0,268,0,2000,232,232,1,0.536,0.697916667
ccfx-30-12,0,268,0,2000,232,232,1,0.536,0.697916667
ccfx-30-1,0,288,16,1984,212,228,0.947368421,0.576,0.71641791
ccfx-30-2,0,288,16,1984,212,228,0.947368421,0.576,0.71641791
ccfx-30-3,0,288,16,1984,212,228,0.947368421,0.576,0.71641791
ccfx-30-4,0,288,16,1984,212,228,0.947368421,0.576,0.71641791
ccfx-30-5,0,288,16,1984,212,228,0.947368421,0.576,0.71641791
ccfx-30-6,0,288,16,1984,212,228,0.947368421,0.576,0.71641791
ccfx-30-7,0,288,16,1984,212,228,0.947368421,0.576,0.71641791
ccfx-30-8,5,276,8,1992,224,232,0.971830986,0.552,0.704081633
ccfx-30-9,5,276,8,1992,224,232,0.971830986,0.552,0.704081633
ccfx-35-10,0,244,0,2000,256,256,1,0.488,0.655913978
ccfx-35-11,0,244,0,2000,256,256,1,0.488,0.655913978
ccfx-35-12,0,244,0,2000,256,256,1,0.488,0.655913978
ccfx-35-1,0,256,8,1992,244,252,0.96969697,0.512,0.670157068
ccfx-35-2,0,256,8,1992,244,252,0.96969697,0.512,0.670157068
ccfx-35-3,0,256,8,1992,244,252,0.96969697,0.512,0.670157068
ccfx-35-4,0,256,8,1992,244,252,0.96969697,0.512,0.670157068
ccfx-35-5,0,256,8,1992,244,252,0.96969697,0.512,0.670157068
ccfx-35-6,0,256,8,1992,244,252,0.96969697,0.512,0.670157068
ccfx-35-7,0,256,8,1992,244,252,0.96969697,0.512,0.670157068
ccfx-35-8,0,252,8,1992,248,256,0.969230769,0.504,0.663157895
ccfx-35-9,0,252,8,1992,248,256,0.969230769,0.504,0.663157895
ccfx-40-10,0,230,0,2000,270,270,1,0.46,0.630136986
ccfx-40-11,0,230,0,2000,270,270,1,0.46,0.630136986
ccfx-40-12,0,230,0,2000,270,270,1,0.46,0.630136986
ccfx-40-1,0,238,8,1992,262,270,0.967479675,0.476,0.638069705
ccfx-40-2,0,238,8,1992,262,270,0.967479675,0.476,0.638069705
ccfx-40-3,0,238,8,1992,262,270,0.967479675,0.476,0.638069705
ccfx-40-4,0,238,8,1992,262,270,0.967479675,0.476,0.638069705
ccfx-40-5,0,238,8,1992,262,270,0.967479675,0.476,0.638069705
ccfx-40-6,0,238,8,1992,262,270,0.967479675,0.476,0.638069705
ccfx-40-7,0,238,8,1992,262,270,0.967479675,0.476,0.638069705
ccfx-40-8,0,234,8,1992,266,274,0.966942149,0.468,0.630727763
ccfx-40-9,0,234,8,1992,266,274,0.966942149,0.468,0.630727763
ccfx-45-10,0,206,0,2000,294,294,1,0.412,0.583569405
ccfx-45-11,0,206,0,2000,294,294,1,0.412,0.583569405
ccfx-45-12,0,206,0,2000,294,294,1,0.412,0.583569405
ccfx-45-1,0,214,0,2000,286,286,1,0.428,0.599439776
ccfx-45-2,0,214,0,2000,286,286,1,0.428,0.599439776
ccfx-45-3,0,214,0,2000,286,286,1,0.428,0.599439776
ccfx-45-4,0,214,0,2000,286,286,1,0.428,0.599439776
ccfx-45-5,0,214,0,2000,286,286,1,0.428,0.599439776
ccfx-45-6,0,214,0,2000,286,286,1,0.428,0.599439776
ccfx-45-7,0,214,0,2000,286,286,1,0.428,0.599439776
ccfx-45-8,0,210,0,2000,290,290,1,0.42,0.591549296
ccfx-45-9,0,210,0,2000,290,290,1,0.42,0.591549296
ccfx-50-10,0,194,0,2000,306,306,1,0.388,0.55907781
ccfx-50-11,0,194,0,2000,306,306,1,0.388,0.55907781
ccfx-50-12,0,194,0,2000,306,306,1,0.388,0.55907781
ccfx-50-1,0,202,0,2000,298,298,1,0.404,0.575498575
ccfx-50-2,0,202,0,2000,298,298,1,0.404,0.575498575
ccfx-50-3,0,202,0,2000,298,298,1,0.404,0.575498575
ccfx-50-4,0,202,0,2000,298,298,1,0.404,0.575498575
ccfx-50-5,0,202,0,2000,298,298,1,0.404,0.575498575
ccfx-50-6,0,202,0,2000,298,298,1,0.404,0.575498575
ccfx-50-7,0,202,0,2000,298,298,1,0.404,0.575498575
ccfx-50-8,0,198,0,2000,302,302,1,0.396,0.567335244
ccfx-50-9,0,198,0,2000,302,302,1,0.396,0.567335244
ccfx-5-10,11,368,90,1910,132,222,0.80349345,0.736,0.768267223
ccfx-5-11,9,346,100,1900,154,254,0.775784753,0.692,0.731501057
ccfx-5-12,4,392,192,1808,108,300,0.671232877,0.784,0.723247232
ccfx-5-1,56,356,42,1958,144,186,0.894472362,0.712,0.792873051
ccfx-5-2,56,356,42,1958,144,186,0.894472362,0.712,0.792873051
ccfx-5-3,56,356,42,1958,144,186,0.894472362,0.712,0.792873051
ccfx-5-4,53,368,60,1940,132,192,0.859813084,0.736,0.793103448
ccfx-5-5,53,332,34,1966,168,202,0.907103825,0.664,0.766743649
ccfx-5-6,46,328,10,1990,172,182,0.970414201,0.656,0.782816229
ccfx-5-7,37,336,8,1992,164,172,0.976744186,0.672,0.796208531
ccfx-5-8,13,410,104,1896,90,194,0.79766537,0.82,0.808678501
ccfx-5-9,12,392,96,1904,108,204,0.803278689,0.784,0.793522267
ccfx-default,0,194,0,2000,306,306,1,0.388,0.55907781
deckard-30-0-0.95,,,,,,,,,
deckard-30-0-1.0,0,242,0,2000,258,258,1,0.484,0.652291105
deckard-30-2-0.95,5,410,44,1956,90,134,0.9030837,0.82,0.859538784
deckard-30-2-1.0,0,306,0,2000,194,194,1,0.612,0.759305211
deckard-50-0-0.95,0,226,0,2000,274,274,1,0.452,0.622589532
deckard-50-0-1.0,0,174,0,2000,326,326,1,0.348,0.516320475
deckard-50-2-0.95,-1,0,0,0,0,2500,0,0,0
deckard-50-2-1.0,0,208,0,2000,292,292,1,0.416,0.587570621
diff,7,397,238,1762,103,341,0.62519685,0.794,0.699559471
gzipncd-1,17,383,94,1906,117,211,0.80293501,0.766,0.784032753
gzipncd-2,24,327,3,1997,173,176,0.990909091,0.654,0.787951807
gzipncd-3,23,349,18,1982,151,169,0.950953678,0.698,0.805074971
gzipncd-4,26,326,3,1997,174,177,0.990881459,0.652,0.786489747
gzipncd-5,22,392,96,1904,108,204,0.803278689,0.784,0.793522267
gzipncd-6,22,410,114,1886,90,204,0.782442748,0.82,0.80078125
gzipncd-7,24,389,72,1928,111,183,0.843817787,0.778,0.809573361
gzipncd-8,25,382,58,1942,118,176,0.868181818,0.764,0.812765957
gzipncd-9,25,384,58,1942,116,174,0.868778281,0.768,0.815286624
gzipncd-default,22,410,114,1886,90,204,0.782442748,0.82,0.80078125
iclones-10-100,0,145,0,2000,355,355,1,0.29,0.449612403
iclones-10-110,0,142,0,2000,358,358,1,0.284,0.442367601
iclones-10-120,0,138,0,2000,362,362,1,0.276,0.432601881
iclones-10-130,0,138,0,2000,362,362,1,0.276,0.432601881
iclones-10-140,0,120,0,2000,380,380,1,0.24,0.387096774
iclones-10-150,0,102,0,2000,398,398,1,0.204,0.338870432
iclones-10-50,0,216,0,2000,284,284,1,0.432,0.603351955
iclones-10-60,0,204,0,2000,296,296,1,0.408,0.579545455
iclones-10-70,0,166,0,2000,334,334,1,0.332,0.498498498
iclones-10-80,0,166,0,2000,334,334,1,0.332,0.498498498
iclones-10-90,0,166,0,2000,334,334,1,0.332,0.498498498
iclones-20-100,0,121,0,2000,379,379,1,0.242,0.389694042
iclones-20-110,0,120,0,2000,380,380,1,0.24,0.387096774
iclones-20-120,0,116,0,2000,384,384,1,0.232,0.376623377
iclones-20-130,0,116,0,2000,384,384,1,0.232,0.376623377
iclones-20-140,0,116,0,2000,384,384,1,0.232,0.376623377
iclones-20-150,0,104,0,2000,396,396,1,0.208,0.344370861
iclones-20-50,0,140,0,2000,360,360,1,0.28,0.4375
iclones-20-60,0,132,0,2000,368,368,1,0.264,0.417721519
iclones-20-70,0,126,0,2000,374,374,1,0.252,0.402555911
iclones-20-80,0,126,0,2000,374,374,1,0.252,0.402555911
iclones-20-90,0,124,0,2000,376,376,1,0.248,0.397435897
iclones-30-100,0,103,0,2000,397,397,1,0.206,0.341625207
iclones-30-110,0,94,0,2000,406,406,1,0.188,0.316498316
iclones-30-120,0,88,0,2000,412,412,1,0.176,0.299319728
iclones-30-130,0,88,0,2000,412,412,1,0.176,0.299319728
iclones-30-140,0,88,0,2000,412,412,1,0.176,0.299319728
iclones-30-150,0,78,0,2000,422,422,1,0.156,0.269896194
iclones-30-50,0,130,0,2000,370,370,1,0.26,0.412698413
iclones-30-60,0,120,0,2000,380,380,1,0.24,0.387096774
iclones-30-70,0,120,0,2000,380,380,1,0.24,0.387096774
iclones-30-80,0,116,0,2000,384,384,1,0.232,0.376623377
iclones-30-90,0,114,0,2000,386,386,1,0.228,0.371335505
iclones-40-100,0,95,0,2000,405,405,1,0.19,0.319327731
iclones-40-110,0,86,0,2000,414,414,1,0.172,0.293515358
iclones-40-120,0,80,0,2000,420,420,1,0.16,0.275862069
iclones-40-130,0,80,0,2000,420,420,1,0.16,0.275862069
iclones-40-140,0,80,0,2000,420,420,1,0.16,0.275862069
iclones-40-150,0,78,0,2000,422,422,1,0.156,0.269896194
iclones-40-50,0,128,0,2000,372,372,1,0.256,0.407643312
iclones-40-60,0,110,0,2000,390,390,1,0.22,0.360655738
iclones-40-70,0,110,0,2000,390,390,1,0.22,0.360655738
iclones-40-80,0,104,0,2000,396,396,1,0.208,0.344370861
iclones-40-90,0,104,0,2000,396,396,1,0.208,0.344370861
iclones-50-100,0,85,0,2000,415,415,1,0.17,0.290598291
iclones-50-110,0,84,0,2000,416,416,1,0.168,0.287671233
iclones-50-120,0,78,0,2000,422,422,1,0.156,0.269896194
iclones-50-130,0,78,0,2000,422,422,1,0.156,0.269896194
iclones-50-140,0,70,0,2000,430,430,1,0.14,0.245614035
iclones-50-150,0,68,0,2000,432,432,1,0.136,0.23943662
iclones-50-50,0,128,0,2000,372,372,1,0.256,0.407643312
iclones-50-60,0,102,0,2000,398,398,1,0.204,0.338870432
iclones-50-70,0,92,0,2000,408,408,1,0.184,0.310810811
iclones-50-80,0,86,0,2000,414,414,1,0.172,0.293515358
iclones-50-90,0,86,0,2000,414,414,1,0.172,0.293515358
iclones-8-100,0,145,0,2000,355,355,1,0.29,0.449612403
iclones-8-110,0,142,0,2000,358,358,1,0.284,0.442367601
iclones-8-120,0,136,0,2000,364,364,1,0.272,0.427672956
iclones-8-130,0,130,0,2000,370,370,1,0.26,0.412698413
iclones-8-140,0,130,0,2000,370,370,1,0.26,0.412698413
iclones-8-150,0,102,0,2000,398,398,1,0.204,0.338870432
iclones-8-50,0,202,0,2000,298,298,1,0.404,0.575498575
iclones-8-60,0,182,0,2000,318,318,1,0.364,0.53372434
iclones-8-70,0,166,0,2000,334,334,1,0.332,0.498498498
iclones-8-80,0,166,0,2000,334,334,1,0.332,0.498498498
iclones-8-90,0,164,0,2000,336,336,1,0.328,0.493975904
inclusion_7zdcd-BZip2-1,44,346,133,1867,154,287,0.722338205,0.692,0.706843718
inclusion_7zdcd-BZip2-3,44,346,133,1867,154,287,0.722338205,0.692,0.706843718
inclusion_7zdcd-BZip2-5,44,346,133,1867,154,287,0.722338205,0.692,0.706843718
inclusion_7zdcd-BZip2-7,45,321,91,1909,179,270,0.779126214,0.642,0.703947368
inclusion_7zdcd-BZip2-9,45,321,91,1909,179,270,0.779126214,0.642,0.703947368
inclusion_7zdcd-Deflate-1,36,318,69,1931,182,251,0.821705426,0.636,0.717023675
inclusion_7zdcd-Deflate-3,36,318,69,1931,182,251,0.821705426,0.636,0.717023675
inclusion_7zdcd-Deflate-5,37,345,100,1900,155,255,0.775280899,0.69,0.73015873
inclusion_7zdcd-Deflate64-1,36,318,69,1931,182,251,0.821705426,0.636,0.717023675
inclusion_7zdcd-Deflate64-3,36,318,69,1931,182,251,0.821705426,0.636,0.717023675
inclusion_7zdcd-Deflate64-5,37,345,100,1900,155,255,0.775280899,0.69,0.73015873
inclusion_7zdcd-Deflate64-7,38,344,94,1906,156,250,0.785388128,0.688,0.73347548
inclusion_7zdcd-Deflate64-9,37,360,112,1888,140,252,0.762711864,0.72,0.740740741
inclusion_7zdcd-Deflate-7,38,344,94,1906,156,250,0.785388128,0.688,0.73347548
inclusion_7zdcd-Deflate-9,37,360,112,1888,140,252,0.762711864,0.72,0.740740741
inclusion_7zdcd-LZMA-1,38,337,101,1899,163,264,0.769406393,0.674,0.718550107
inclusion_7zdcd-LZMA2-1,38,340,101,1899,160,261,0.770975057,0.68,0.722635494
inclusion_7zdcd-LZMA2-3,38,341,102,1898,159,261,0.769751693,0.682,0.723223754
inclusion_7zdcd-LZMA2-5,41,334,81,1919,166,247,0.804819277,0.668,0.730054645
inclusion_7zdcd-LZMA2-7,42,337,78,1922,163,241,0.812048193,0.674,0.736612022
inclusion_7zdcd-LZMA2-9,42,337,78,1922,163,241,0.812048193,0.674,0.736612022
inclusion_7zdcd-LZMA-3,38,338,102,1898,162,264,0.768181818,0.676,0.719148936
inclusion_7zdcd-LZMA-5,41,334,80,1920,166,246,0.806763285,0.668,0.730853392
inclusion_7zdcd-LZMA-7,42,337,78,1922,163,241,0.812048193,0.674,0.736612022
inclusion_7zdcd-LZMA-9,42,337,78,1922,163,241,0.812048193,0.674,0.736612022
inclusion_7zdcd-PPMd-1,37,335,179,1821,165,344,0.651750973,0.67,0.660749507
inclusion_7zdcd-PPMd-3,37,335,179,1821,165,344,0.651750973,0.67,0.660749507
inclusion_7zdcd-PPMd-5,42,306,81,1919,194,275,0.790697674,0.612,0.689966178
inclusion_7zdcd-PPMd-7,45,314,68,1932,186,254,0.821989529,0.628,0.712018141
inclusion_7zdcd-PPMd-9,44,334,76,1924,166,242,0.814634146,0.668,0.734065934
jplag-java-10,9,336,40,1960,164,204,0.893617021,0.672,0.767123288
jplag-java-11,5,366,88,1912,134,222,0.806167401,0.732,0.767295597
jplag-java-12,0,354,40,1960,146,186,0.898477157,0.708,0.791946309
jplag-java-1,79,328,84,1916,172,256,0.796116505,0.656,0.719298246
jplag-java-2,65,340,22,1978,160,182,0.939226519,0.68,0.788863109
jplag-java-3,43,432,142,1858,68,210,0.75261324,0.864,0.804469274
jplag-java-4,37,376,76,1924,124,200,0.831858407,0.752,0.789915966
jplag-java-5,28,378,76,1924,122,198,0.832599119,0.756,0.79245283
jplag-java-6,30,326,8,1992,174,182,0.976047904,0.652,0.78177458
jplag-java-7,17,368,56,1944,132,188,0.867924528,0.736,0.796536797
jplag-java-8,9,396,98,1902,104,202,0.801619433,0.792,0.796780684
jplag-java-9,9,368,56,1944,132,188,0.867924528,0.736,0.796536797
jplag-java-default,9,368,56,1944,132,188,0.867924528,0.736,0.796536797
jplag-text-10,0,350,38,1962,150,188,0.902061856,0.7,0.788288288
jplag-text-11,0,292,30,1970,208,238,0.906832298,0.584,0.710462287
jplag-text-12,0,281,26,1974,219,245,0.915309446,0.562,0.696406444
jplag-text-1,45,389,75,1925,111,186,0.838362069,0.778,0.807053942
jplag-text-2,30,369,38,1962,131,169,0.906633907,0.738,0.813671444
jplag-text-3,17,390,58,1942,110,168,0.870535714,0.78,0.82278481
jplag-text-4,9,380,94,1906,120,214,0.801687764,0.76,0.780287474
jplag-text-5,5,399,172,1828,101,273,0.698774081,0.798,0.745098039
jplag-text-6,3,436,175,1825,64,239,0.713584288,0.872,0.784878488
jplag-text-7,3,428,92,1908,72,164,0.823076923,0.856,0.839215686
jplag-text-8,2,448,96,1904,52,148,0.823529412,0.896,0.858237548
jplag-text-9,2,358,74,1926,142,216,0.828703704,0.716,0.768240343
jplag-text-default,5,399,172,1828,101,273,0.698774081,0.798,0.745098039
lucene,62,250,106,1894,250,356,0.702247191,0.5,0.58411215
ncd-bzlib,31,400,66,1934,100,166,0.858369099,0.8,0.82815735
ncd-zlib,23,391,67,1933,109,176,0.85371179,0.782,0.816283925
nicad-0.0,0,82,0,2000,418,418,1,0.164,0.281786942
nicad-0.1,0,86,0,2000,414,414,1,0.172,0.293515358
nicad-0.2,0,118,0,2000,382,382,1,0.236,0.381877023
nicad-0.4,6,174,8,1992,326,334,0.956043956,0.348,0.51026393
nicad-0.5,7,286,42,1958,214,256,0.87195122,0.572,0.690821256
nicad-0.6,19,290,192,1808,210,402,0.601659751,0.58,0.590631365
nicad-0.7,68,253,113,1887,247,360,0.691256831,0.506,0.584295612
nicad-0.8,73,450,1158,842,50,1208,0.279850746,0.9,0.426944972
nicad-0.9,79,420,1436,564,80,1516,0.226293103,0.84,0.356536503
nicad-abstractconditions,0,120,0,2000,380,380,1,0.24,0.387096774
nicad-abstractexpressions-0.0,0,246,0,2000,254,254,1,0.492,0.659517426
nicad-abstractexpressions-0.2,18,272,20,1980,228,248,0.931506849,0.544,0.686868687
nicad-abstractexpressions-0.3,32,317,114,1886,183,297,0.73549884,0.634,0.680988185
nicad-abstractexpressions-0.4,68,241,60,1940,259,319,0.800664452,0.482,0.601747815
nicad-abstractexpressions-0.5,83,271,502,1498,229,731,0.350582147,0.542,0.425765907
nicad-abstractexpressions-0.6,60,494,1676,324,6,1682,0.22764977,0.988,0.370037453
nicad-abstractexpressions-blindrename,0,282,16,1984,218,234,0.946308725,0.564,0.706766917
nicad-abstractexpressions-consistentrename,0,278,16,1984,222,238,0.945578231,0.556,0.700251889
nicad-abstractexpressions,0,274,0,2000,226,226,1,0.548,0.708010336
nicad-blindrename,0,246,16,1984,254,270,0.938931298,0.492,0.645669291
nicad-consistentrename,0,230,16,1984,270,286,0.93495935,0.46,0.616621984
nicad-filterdeclarations,0,140,0,2000,360,360,1,0.28,0.4375
nicad-javanormalizeifconditions,-1,0,0,0,0,2500,0,0,0
nicad-metrics,7,286,42,1958,214,256,0.87195122,0.572,0.690821256
nicad-type1,0,82,0,2000,418,418,1,0.164,0.281786942
nicad-type2c,0,156,0,2000,344,344,1,0.312,0.475609756
nicad-type2,0,170,0,2000,330,330,1,0.34,0.507462687
nicad-type3-1,0,140,0,2000,360,360,1,0.28,0.4375
nicad-type3-2c,0,230,16,1984,270,286,0.93495935,0.46,0.616621984
nicad-type3-2,0,246,16,1984,254,270,0.938931298,0.492,0.645669291
plaggie-10,9,366,62,1938,134,196,0.855140187,0.732,0.788793103
plaggie-11,9,364,62,1938,136,198,0.854460094,0.728,0.786177106
plaggie-12,13,308,26,1974,192,218,0.922155689,0.616,0.738609113
plaggie-13,11,310,20,1980,190,210,0.939393939,0.62,0.746987952
plaggie-14,9,301,12,1988,199,211,0.961661342,0.602,0.740467405
plaggie-1,90,242,170,1830,258,428,0.587378641,0.484,0.530701754
plaggie-2,74,309,196,1804,191,387,0.611881188,0.618,0.614925373
plaggie-3,58,349,146,1854,151,297,0.705050505,0.698,0.701507538
plaggie-4,46,354,80,1920,146,226,0.815668203,0.708,0.758029979
plaggie-5,34,382,87,1913,118,205,0.814498934,0.764,0.788441692
plaggie-6,27,390,78,1922,110,188,0.833333333,0.78,0.805785124
plaggie-7,18,406,83,1917,94,177,0.830265849,0.812,0.821031345
plaggie-8,15,376,68,1932,124,192,0.846846847,0.752,0.796610169
plaggie-9,9,398,98,1902,102,200,0.802419355,0.796,0.799196787
plaggie-default,9,364,62,1938,136,198,0.854460094,0.728,0.786177106
py-difflib.SM_autojunk,13,375,83,1917,125,208,0.818777293,0.75,0.782881002
py-difflib.SM_noautojunk,35,397,49,1951,103,152,0.890134529,0.794,0.839323467
py-difflib.SM_nowhitespace_autojunk,13,358,62,1938,142,204,0.852380952,0.716,0.77826087
py-difflib.SM_nowhitespace_noautojunk,19,420,96,1904,80,176,0.813953488,0.84,0.826771654
py-fuzzywuzzy.partial_ratio,21,328,92,1908,172,264,0.780952381,0.656,0.713043478
py-fuzzywuzzy.partial_token_sort_ratio,16,296,118,1882,204,322,0.714975845,0.592,0.647702407
py-fuzzywuzzy.ratio,13,375,83,1917,125,208,0.818777293,0.75,0.782881002
py-fuzzywuzzy.token_set_ratio,80,392,68,1932,108,176,0.852173913,0.784,0.816666667
py-fuzzywuzzy.token_sort_ratio,10,270,55,1945,230,285,0.830769231,0.54,0.654545455
py-jellyfish.jaro_distance,76,322,222,1778,178,400,0.591911765,0.644,0.616858238
py-jellyfish.jaro_winkler,78,360,322,1678,140,462,0.527859238,0.72,0.609137056
py-ngram.compare,43,378,76,1924,122,198,0.832599119,0.756,0.79245283
py-sklearn.cosine_similarity,33,402,280,1720,98,378,0.589442815,0.804,0.680203046
sherlock1-1-0,48,476,384,1616,24,408,0.553488372,0.952,0.7
sherlock1-1-1,45,392,228,1772,108,336,0.632258065,0.784,0.7
sherlock1-1-2,53,390,258,1742,110,368,0.601851852,0.78,0.679442509
sherlock1-1-3,66,358,260,1740,142,402,0.579288026,0.716,0.640429338
sherlock1-1-4,65,262,86,1914,238,324,0.752873563,0.524,0.617924528
sherlock1-1-5,58,378,590,1410,122,712,0.390495868,0.756,0.514986376
sherlock1-1-6,37,191,306,1694,309,615,0.384305835,0.382,0.383149448
sherlock1-1-7,23,134,314,1686,366,680,0.299107143,0.268,0.282700422
sherlock1-1-8,0,21,0,2000,479,479,1,0.042,0.080614203
sherlock1-2-0,23,352,144,1856,148,292,0.709677419,0.704,0.706827309
sherlock1-2-1,27,356,148,1852,144,292,0.706349206,0.712,0.709163347
sherlock1-2-2,22,442,288,1712,58,346,0.605479452,0.884,0.718699187
sherlock1-2-3,34,382,148,1852,118,266,0.720754717,0.764,0.741747573
sherlock1-2-4,26,324,136,1864,176,312,0.704347826,0.648,0.675
sherlock1-2-5,40,274,106,1894,226,332,0.721052632,0.548,0.622727273
sherlock1-2-6,0,352,820,1180,148,968,0.300341297,0.704,0.421052632
sherlock1-2-7,0,300,644,1356,200,844,0.31779661,0.6,0.415512465
sherlock1-2-8,0,289,644,1356,211,855,0.309753483,0.578,0.403349616
sherlock1-3-0,11,352,108,1892,148,256,0.765217391,0.704,0.733333333
sherlock1-3-1,9,350,124,1876,150,274,0.738396624,0.7,0.718685832
sherlock1-3-2,12,314,48,1952,186,234,0.867403315,0.628,0.728538283
sherlock1-3-3,15,316,46,1954,184,230,0.872928177,0.632,0.733178654
sherlock1-3-4,19,310,130,1870,190,320,0.704545455,0.62,0.659574468
sherlock1-3-5,13,306,92,1908,194,286,0.768844221,0.612,0.681514477
sherlock1-3-6,6,340,200,1800,160,360,0.62962963,0.68,0.653846154
sherlock1-3-7,11,330,162,1838,170,332,0.670731707,0.66,0.665322581
sherlock1-3-8,0,229,48,1952,271,319,0.826714801,0.458,0.589446589
sherlock1-4-0,4,370,130,1870,130,260,0.74,0.74,0.74
sherlock1-4-1,4,410,120,1880,90,210,0.773584906,0.82,0.796116505
sherlock1-4-2,5,374,70,1930,126,196,0.842342342,0.748,0.792372881
sherlock1-4-3,6,332,76,1924,168,244,0.81372549,0.664,0.731277533
sherlock1-4-4,2,386,180,1820,114,294,0.681978799,0.772,0.724202627
sherlock1-4-5,4,332,56,1944,168,224,0.855670103,0.664,0.747747748
sherlock1-4-6,7,258,20,1980,242,262,0.928057554,0.516,0.663239075
sherlock1-4-7,0,173,4,1996,327,331,0.97740113,0.346,0.511078287
sherlock1-4-8,0,154,0,2000,346,346,1,0.308,0.470948012
sherlock1-5-0,2,358,124,1876,142,266,0.742738589,0.716,0.729124236
sherlock1-5-1,3,324,100,1900,176,276,0.764150943,0.648,0.701298701
sherlock1-5-2,3,326,96,1904,174,270,0.772511848,0.652,0.707158351
sherlock1-5-3,2,306,122,1878,194,316,0.714953271,0.612,0.659482759
sherlock1-5-4,2,334,270,1730,166,436,0.552980132,0.668,0.605072464
sherlock1-5-5,4,278,66,1934,222,288,0.808139535,0.556,0.658767773
sherlock1-5-6,2,294,94,1906,206,300,0.757731959,0.588,0.662162162
sherlock1-5-7,14,162,10,1990,338,348,0.941860465,0.324,0.482142857
sherlock1-5-8,20,93,16,1984,407,423,0.853211009,0.186,0.305418719
sherlock1-6-0,1,342,116,1884,158,274,0.746724891,0.684,0.713987474
sherlock1-6-1,1,350,60,1940,150,210,0.853658537,0.7,0.769230769
sherlock1-6-2,1,364,54,1946,136,190,0.870813397,0.728,0.793028322
sherlock1-6-3,1,396,60,1940,104,164,0.868421053,0.792,0.828451883
sherlock1-6-4,0,440,140,1860,60,200,0.75862069,0.88,0.814814815
sherlock1-6-5,0,374,62,1938,126,188,0.857798165,0.748,0.799145299
sherlock1-6-6,2,364,30,1970,136,166,0.923857868,0.728,0.814317673
sherlock1-6-7,0,236,16,1984,264,280,0.936507937,0.472,0.627659574
sherlock1-6-8,0,161,0,2000,339,339,1,0.322,0.487140696
sherlock1-7-0,1,284,60,1940,216,276,0.825581395,0.568,0.672985782
sherlock1-7-1,0,346,148,1852,154,302,0.700404858,0.692,0.696177062
sherlock1-7-2,0,338,126,1874,162,288,0.728448276,0.676,0.701244813
sherlock1-7-3,0,372,94,1906,128,222,0.798283262,0.744,0.770186335
sherlock1-7-4,1,358,42,1958,142,184,0.895,0.716,0.795555556
sherlock1-7-5,0,276,30,1970,224,254,0.901960784,0.552,0.684863524
sherlock1-7-6,0,222,26,1974,278,304,0.89516129,0.444,0.593582888
sherlock1-7-7,5,193,2,1998,307,309,0.98974359,0.386,0.555395683
sherlock1-7-8,0,174,2,1998,326,328,0.988636364,0.348,0.514792899
sherlock1-8-0,0,302,70,1930,198,268,0.811827957,0.604,0.69266055
sherlock1-8-1,1,262,48,1952,238,286,0.84516129,0.524,0.64691358
sherlock1-8-2,1,252,56,1944,248,304,0.818181818,0.504,0.623762376
sherlock1-8-3,0,310,102,1898,190,292,0.752427184,0.62,0.679824561
sherlock1-8-4,0,308,62,1938,192,254,0.832432432,0.616,0.708045977
sherlock1-8-5,1,232,58,1942,268,326,0.8,0.464,0.587341772
sherlock1-8-6,0,206,66,1934,294,360,0.757352941,0.412,0.533678756
sherlock1-8-7,8,134,62,1938,366,428,0.683673469,0.268,0.385057471
sherlock1-8-8,0,119,58,1942,381,439,0.672316384,0.238,0.35155096
sherlock1-default,19,310,130,1870,190,320,0.704545455,0.62,0.659574468
simian-2,2,334,124,1876,166,290,0.729257642,0.668,0.697286013
simian-2-ignoreCharacters,2,334,124,1876,166,290,0.729257642,0.668,0.697286013
simian-2-ignoreIdentifiers,9,452,252,1748,48,300,0.642045455,0.904,0.750830565
simian-2-ignoreLiterals,3,323,66,1934,177,243,0.83033419,0.646,0.726659168
simian-2-ignoreVariableNames,11,413,159,1841,87,246,0.722027972,0.826,0.770522388
simian-3,0,278,36,1964,222,258,0.885350318,0.556,0.683046683
simian-3-ignoreCharacters,0,278,36,1964,222,258,0.885350318,0.556,0.683046683
simian-3-ignoreIdentifiers,5,428,186,1814,72,258,0.697068404,0.856,0.768402154
simian-3-ignoreLiterals,0,310,36,1964,190,226,0.895953757,0.62,0.73286052
simian-3-ignoreVariableNames,3,448,149,1851,52,201,0.75041876,0.896,0.816773017
simian-4,0,202,0,2000,298,298,1,0.404,0.575498575
simian-4-ignoreCharacters,0,202,0,2000,298,298,1,0.404,0.575498575
simian-4-ignoreIdentifiers,3,400,77,1923,100,177,0.838574423,0.8,0.818833163
simian-4-ignoreLiterals,0,202,0,2000,298,298,1,0.404,0.575498575
simian-4-ignoreVariableNames,2,394,66,1934,106,172,0.856521739,0.788,0.820833333
simian-5,0,160,0,2000,340,340,1,0.32,0.484848485
simian-5-ignoreCharacters,0,160,0,2000,340,340,1,0.32,0.484848485
simian-5-ignoreIdentifiers,0,388,2,1998,112,114,0.994871795,0.776,0.871910112
simian-5-ignoreLiterals,0,164,0,2000,336,336,1,0.328,0.493975904
simian-5-ignoreVariableNames,0,378,0,2000,122,122,1,0.756,0.861047836
simian-6,0,134,0,2000,366,366,1,0.268,0.422712934
simian-6-ignoreCharacters,0,134,0,2000,366,366,1,0.268,0.422712934
simian-6-ignoreIdentifiers,0,308,0,2000,192,192,1,0.616,0.762376238
simian-6-ignoreLiterals,0,138,0,2000,362,362,1,0.276,0.432601881
simian-6-ignoreVariableNames,0,292,0,2000,208,208,1,0.584,0.737373737
simjava-10,34,344,60,1940,156,216,0.851485149,0.688,0.761061947
simjava-11,29,354,82,1918,146,228,0.811926606,0.708,0.756410256
simjava-12,19,378,128,1872,122,250,0.747035573,0.756,0.751491054
simjava-13,18,376,92,1908,124,216,0.803418803,0.752,0.776859504
simjava-14,14,390,104,1896,110,214,0.789473684,0.78,0.784708249
simjava-15,11,392,92,1908,108,200,0.809917355,0.784,0.796747967
simjava-16,12,392,82,1918,108,190,0.827004219,0.784,0.804928131
simjava-17,6,430,148,1852,70,218,0.743944637,0.86,0.797773655
simjava-18,4,460,160,1840,40,200,0.741935484,0.92,0.821428571
simjava-19,4,460,116,1884,40,156,0.798611111,0.92,0.855018587
simjava-20,4,456,100,1900,44,144,0.820143885,0.912,0.863636364
simjava-21,5,456,76,1924,44,120,0.857142857,0.912,0.88372093
simjava-22,5,456,64,1936,44,108,0.876923077,0.912,0.894117647
simjava-23,5,396,48,1952,104,152,0.891891892,0.792,0.838983051
simjava-24,5,396,48,1952,104,152,0.891891892,0.792,0.838983051
simjava-25,5,388,40,1960,112,152,0.906542056,0.776,0.836206897
simjava-26,5,384,40,1960,116,156,0.905660377,0.768,0.831168831
simjava-27,0,428,108,1892,72,180,0.798507463,0.856,0.826254826
simjava-28,0,416,66,1934,84,150,0.863070539,0.832,0.847250509
simjava-default,5,396,48,1952,104,152,0.891891892,0.792,0.838983051
simtext-10,0,172,2,1998,328,330,0.988505747,0.344,0.510385757
simtext-11,0,164,0,2000,336,336,1,0.328,0.493975904
simtext-12,0,146,0,2000,354,354,1,0.292,0.452012384
simtext-4,17,262,170,1830,238,408,0.606481481,0.524,0.56223176
simtext-5,17,228,86,1914,272,358,0.72611465,0.456,0.56019656
simtext-6,21,192,38,1962,308,346,0.834782609,0.384,0.526027397
simtext-7,15,188,20,1980,312,332,0.903846154,0.376,0.531073446
simtext-8,0,180,22,1978,320,342,0.891089109,0.36,0.512820513
simtext-9,0,178,10,1990,322,332,0.946808511,0.356,0.51744186
simtext-default,0,180,22,1978,320,342,0.891089109,0.36,0.512820513